hair - dobro, sreća, korist
hava - zrak
imam - islamski vjerski poglavar, svećenik
ašik - ljubav, udvaranje
iman - vjerovanje u Boga
farz - obavezna djela u islamu
ezan - poziv za molitvu sa munare
nefs - strast, žudnja
dova - molitva
ajet - rečenica ili red iz Kur'ana
sura - poglavlje Kur'ana
šiša - boca
avaz - glas; grlo
šejh - starješina tekije
ters - neprijazan, nervozan, zloćudan
evlad - djeca, potomstvo
učkur - uzica, tanak pojas od platna
bošča - marama; stolnjak
vakat - vrijeme
behut - opijenost; nesvjestica
telal - razglasnik, objavljivač
tabut - muslimanski mrtvački sanduk
titiz - škrtica
alčak - prepredenjak; vrtirep
vakuf - vjerska zaklada, ostavština zajednici
baška - posebno, nastranu
šeher - grad
šićar - (v. ušićariti) korist, dobitak (okoristiti se, zaraditi)
šehid - borac koji je umro na Božijem putu
šerbe - slatki voćni sok
čehra - izraz lica
čorba - gusta supa
almas - dijamant
ćumur - drveni ugalj
sokak - uska ulica
ćafir - nevjernik, inovjerac
safra - nesvijest
dever - briga, patnja, oskudica
sabur - strpljenje
sabah - zora, svitanje Sunca
divit - mastionica
sehur - obrok u zoru za vrijeme ramazana
sevap - dobro, Bogu ugodno djelo
sofra - trpeza, stol
ahbab - prijatelj
rahat - biti biti miran, spokojan, udoban, zadovoljan
damar - srce, bilo
plaho - fino, dobro
namaz - molitva
zulum - (zulumčar) nasilje, nepravda, okrutnost (nasilnik)
mezar - grob
melek - anđeo
džuma - petak (češće: molitva petkom)
leđen - bakrena posuda za umivanje
đugum - veliki mjedeni vrč za vodu
levha - kaligrafski ispisan citat iz Kur'ana i sl.
kuvet - snaga, krepost
kabur - grob
kabul - (v. kabuliti) pristanak, dopuštenje
zijan - (zijančer) šteta, kvar (štetočina)
ulema - učenjaci, intelektualni vrh zajednice
akšam - sumrak, večer
kitab - / ćitab knjiga
insan - čovjek
fajda - korist, dobitak
Zebur - Novi zavjet
zehra - malo, mrvica
hamal - nosač
ibrik - bakreni vrč za vodu sa posebnim lijevkom
iftar - večera nakon dnevnog posta u ramazanu
hatib - govornik, propovjednik
hrsuz - razbojnik, lopov, hrđava osoba
helać - propast, nesreća, šteta, kvar
hafiz - (onaj koji čuva, pamti) čovjek koji zna Kur'an napamet
haram - zabranjeno djelo u Islamu
hećim - ljekar
ahlak - moral, lijepo ponašanje
halal - dozvoljeno, pohvano djelo u islamu
hatma - čitanje čitavog Kur'ana s namjerom
hajat - hodnik, predsoblje
zapis - hamajlija (protiv uroka, bolesti i sl.)
ibadet - moliva, služenje Bogu
hairli - sretan, čestit, napredan
hadždž - hodočašće u Mekku
hidžab - žensko pokrivalo za glavu (ili lice)
hurija - rajska djevica
hajvan - životinja
zekjat - obavezno dijeljenje pomoći sirotinji (2.5% godišnjih prihoda
avlija - dvorište ispred kuće
hanuma - žena, gospođa
zejtin - ulje
hastal - stol
hejbet - mnogo
abdest - pranje prije molitve
hedija - dar, poklon
halvat - oba (najčešće u prizemlju kuće)
zahmet - trud, muka, naporan posao, nevolja
ašćare - očigledno
bostan - lubenica; vrt ili voćnjak
tokmak - budala, glupan
gurbet - skitnica, tuđin
Indžil - Evanđelje
fukara - sirotinja
tefter - popis; bilježnica, lista
hizmet - pomoć, posluženje
išaret - gest, signal, znak; naslućivanje
taraba - ograda od dasaka, plot
kadija - sudija u šerijatskom sistemu
kaduna - dama, gospođa
tevhid - molitva za umrlog (učestvuju samo žene)
bulbul - slavuj
tekija - samostan” za derviše
tabija - utvrđenje, opkop, bedem, utvrda
Tevrat - Tora
tespih - „brojanica” za ibadet
bilesi - čak i…
kismet - sudbina
peškeš - poklon
šejtan - đavo
ligure - sanke
bujrum - izvoli, dobro došao
šenluk - (v. šenlučiti) veselje, zabava (slaviti, veseliti se)
čardak - zgrada; gornji sprat kuće
ćenifa - toalet, wc
serbez - slobodno, bez straha, sigurno
munara - toranj džamije
minder - divan, sećija, kauč
maksuz - specijalno, posebno, osobito
sevdah - ljubav
sećija - poširoka klupa zastrta ćilimima
dilber - dragi/draga, voljeni, zanosni
mekteb - vjerska osnovna škola
srklet - uzrujanost, muka, patnja, tegoba
džemat - društvo, zajednica
sijelo - okupljanje prijatelja (najčešće noću)
sunnet - pravila postavljena životom Muhammeda
nafaka - ono što je čovjeku suđeno da ima za života; sudbina
džezva - bakrena posuda za spravljanje kafe
durati - trpjeti, nositi se s nečim
ahiret - „drugi” (zagrobni) svijet
basamak - (mn. basamaci) stepenica
Džennet - raj
zinaluk - blud
hafifan - nesiguran, nepouzdan
hikjaja - priča, legenda
zembilj - trokutasta kožna torba
vaktija - vremenski raspored obavljanja vjerskih dužnosti, satnica
pesinav - prljav
ujdurma - smicalica, prevrtljivost, podvala
fildžan - porculanska šoljica za kafu bez drške
bezbeli - naravno, mora da jeste, dabome
bukadar - puno, velika hrpa
teferič - veselje, zabava (najčešće u prirodi)
kijamet - posljednji sud; nevrijeme; pometnja
musafir - gost
kandilj - svjetla kojima se ukrašava munara
medresa - vjerska srednja škola
mangala - posuda za žeravicu
đuturum - starac, onemoćali, oronuo čovjek
šerijat - vjerski zakon, pravila
mubarek - sretan, blagoslovljen
deverli - glave kad neko nema sreće, samo brige
muhabet - (v. muhabetiti) razgovor
šehadet - osnovna izjava vjere u Islamu
dženaza - sprovod, sahrana
mujezin - čovjek koji sa munare poziva na molitvu
čakšire - muške hlače
ibretiti - se čuditi se
dunjaluk - svijet
deverati - mučiti se, brinuti se
bezistan - bazar, zatvoreno mjesto za trgovinu
sabahile - rano ujutro, zorom
pehlivan - cirkusant; hrvač; komedijaš
peksimet - kolač, slastica
hastaluk - (hasta) bolest (bolesnik)
ašiklija - onaj koji ašikuje; ljubavna pjesma
đuvegija - zaručnik, mladoženja
akšamluk - večernji razgovor, druženje u sumrak
merhamet - samilost, milosrđe
aščinica - restoran tradicionalne hrane
pesinluk - prljavština
divaniti - razgovarati
muštuluk - dobra vijest ili nagrada za istu
tabiriti - tumačiti, proučavati detaljno,
istihare - želja
đulistan - ružičnjak
rahmetli - pokojni
efendija - gospodin
havizati - (uhavizati) razumjeti, shvatiti
rahatluk - spokojstvo, bezbrižnost, uživanje
fasovati - dobiti, primiti
mahaluša - žena koja puno ogovara, tračara
teravija - posebna molitva za ramazan
pohasiti - se uzgoguniti se, postati drzak
Džehennem - pakao
bailisati - se onesvijestiti se
divanhana - soba za razgovor
saulisati - smiriti, svladati
pejgamber - Božiji poslanik
sevdisati - ljubovati; čeznuti za nekim
osunetiti - obrezati mušku djecu po propisima
harabatija - rasipnik, boem, pijanica
marifetluk - zavaravanje, petljavina
hašarijast - nestašan, vragolast
đulbešećer - džem od latica posebne vrste ruže
bihuzuriti - uznemiravati, smetati
kutarisati - riješiti, osloboditi
birvaktile - nekada, „u ono doba”
kaliferija - šinteraj
